10 10
1	1	1	1	1	1	1	1	1	1
1	0	0	0	2	0	0	0	1	1
1	0	-4	0	2	0	-3	0	1	1
1	0	0	0	2	0	0	0	1	1
1	0	0	0	1	0	0	0	1	1
1	0	0	0	3	2	2	2	1	1
0	0	0	0	1	0	0	0	0	0
-6	0	-5	0	1	0	-2	0	0	-1
0	0	0	0	1	0	0	0	0	0
1	1	1	1	1	1	1	1	1	1

1 5 0.5
2 2 1
-1
0 3 0.75
3 1 1
-1
-1