15 15
1 1 1 1 1 1 1 1 1 1 1 1 1 -1 1 
1 0 0 0 0 0 0 2 0 0 0 0 0 0 1 
1 0 -3 0 0 0 0 2 0 0 0 0 0 -2 1 
1 0 0 0 0 0 0 2 0 0 0 0 0 0 1 
1 0 0 0 1 1 1 1 1 1 1 1 1 1 1
1 0 0 0 1 1 1 1 1 1 1 0 0 0 0 
1 2 2 2 1 1 1 1 1 1 1 0 -6 0 -7  
1 0 0 0 1 1 1 3 1 1 1 0 0 0 0 
1 0 0 0 1 1 1 1 1 1 1 0 0 0 1 
1 0 0 0 1 1 1 1 1 1 1 0 0 0 1 
1 0 0 0 0 0 0 2 0 0 0 0 0 0 1 
1 0 -4 0 0 0 0 2 0 0 0 0 -5 0 1 
1 0 0 0 0 0 0 2 0 0 0 0 0 0 1 
1 1 1 1 1 1 1 1 1 1 1 1 1 1 1 
1 1 1 1 1 1 1 1 1 1 1 1 1 1 1 

1 15 0.5
0 13 0.5
-1
2 15 1
-1
3 3 0.1
-1
-1