15 15
1 1 -1 1 1 1 1 1 1 1 1 1 1 1 1 
1 0 0 0 1 1 1 0 0 0 2 0 0 0 1 
1 0 0 0 1 1 1 0 -4 0 2 0 -5 0 1 
1 0 0 0 1 1 1 0 0 0 2 0 0 0 1 
1 0 0 0 1 1 1 0 0 0 1 0 0 0 1 
1 0 0 0 1 1 1 0 0 0 1 0 0 0 1 
1 2 2 2 1 1 1 2 2 2 1 2 2 2 1 
1 0 0 0 1 1 1 0 0 0 1 0 0 0 1 
1 0 0 0 1 1 1 0 0 0 1 0 0 0 1 
1 0 0 0 1 3 1 0 0 0 1 0 0 0 1 
1 0 0 0 1 1 1 0 0 0 1 0 0 0 1 
1 0 0 0 0 2 0 0 0 0 1 0 0 0 1 
1 0 -2 0 0 2 0 0 -3 0 1 0 0 0 1 
1 0 0 0 0 2 0 0 0 0 1 0 0 0 1 
1 1 1 1 1 1 1 1 1 1 1 0 -6 0 1  

2 15 1.5
1 15 0.5
-1
2 15 1.5
0 10 1
-1
-1